"filename", "language", "JSON", "JavaScript", "HTML", "comment", "blank", "total"
"c:\Users\jondm\OneDrive\Desktop\Projects\capstone-bakery-inventory-manager\frontend\package-lock.json", "JSON", 18434, 0, 0, 0, 1, 18435
"c:\Users\jondm\OneDrive\Desktop\Projects\capstone-bakery-inventory-manager\frontend\package.json", "JSON", 38, 0, 0, 0, 1, 39
"c:\Users\jondm\OneDrive\Desktop\Projects\capstone-bakery-inventory-manager\frontend\public\index.html", "HTML", 0, 0, 26, 10, 1, 37
"c:\Users\jondm\OneDrive\Desktop\Projects\capstone-bakery-inventory-manager\frontend\src\App.js", "JavaScript", 0, 36, 0, 0, 4, 40
"c:\Users\jondm\OneDrive\Desktop\Projects\capstone-bakery-inventory-manager\frontend\src\components\Home.js", "JavaScript", 0, 129, 0, 1, 4, 134
"c:\Users\jondm\OneDrive\Desktop\Projects\capstone-bakery-inventory-manager\frontend\src\components\bakes\BakesList.js", "JavaScript", 0, 7, 0, 0, 0, 7
"c:\Users\jondm\OneDrive\Desktop\Projects\capstone-bakery-inventory-manager\frontend\src\components\common\Alerts.js", "JavaScript", 0, 26, 0, 0, 4, 30
"c:\Users\jondm\OneDrive\Desktop\Projects\capstone-bakery-inventory-manager\frontend\src\components\common\Header.js", "JavaScript", 0, 10, 0, 0, 0, 10
"c:\Users\jondm\OneDrive\Desktop\Projects\capstone-bakery-inventory-manager\frontend\src\components\common\ScrollToTop.js", "JavaScript", 0, 9, 0, 1, 4, 14
"c:\Users\jondm\OneDrive\Desktop\Projects\capstone-bakery-inventory-manager\frontend\src\components\common\UnitSelector.js", "JavaScript", 0, 28, 0, 0, 4, 32
"c:\Users\jondm\OneDrive\Desktop\Projects\capstone-bakery-inventory-manager\frontend\src\components\common\page-toolbar\LoginButton.js", "JavaScript", 0, 65, 0, 0, 7, 72
"c:\Users\jondm\OneDrive\Desktop\Projects\capstone-bakery-inventory-manager\frontend\src\components\common\page-toolbar\LoginModal.js", "JavaScript", 0, 132, 0, 5, 15, 152
"c:\Users\jondm\OneDrive\Desktop\Projects\capstone-bakery-inventory-manager\frontend\src\components\common\page-toolbar\PageToolbar.js", "JavaScript", 0, 72, 0, 0, 6, 78
"c:\Users\jondm\OneDrive\Desktop\Projects\capstone-bakery-inventory-manager\frontend\src\components\common\page-toolbar\RegisterModal.js", "JavaScript", 0, 238, 0, 7, 16, 261
"c:\Users\jondm\OneDrive\Desktop\Projects\capstone-bakery-inventory-manager\frontend\src\components\common\page-toolbar\ToolbarDropdown.js", "JavaScript", 0, 41, 0, 0, 5, 46
"c:\Users\jondm\OneDrive\Desktop\Projects\capstone-bakery-inventory-manager\frontend\src\components\ingredients\IngredientsCreate.js", "JavaScript", 0, 7, 0, 0, 0, 7
"c:\Users\jondm\OneDrive\Desktop\Projects\capstone-bakery-inventory-manager\frontend\src\components\ingredients\IngredientsList.js", "JavaScript", 0, 7, 0, 0, 0, 7
"c:\Users\jondm\OneDrive\Desktop\Projects\capstone-bakery-inventory-manager\frontend\src\components\recipes\AddIngredientForm.js", "JavaScript", 0, 71, 0, 2, 8, 81
"c:\Users\jondm\OneDrive\Desktop\Projects\capstone-bakery-inventory-manager\frontend\src\components\recipes\IngredientSelector.js", "JavaScript", 0, 29, 0, 0, 3, 32
"c:\Users\jondm\OneDrive\Desktop\Projects\capstone-bakery-inventory-manager\frontend\src\components\recipes\RecipeIngredientsList.js", "JavaScript", 0, 20, 0, 0, 4, 24
"c:\Users\jondm\OneDrive\Desktop\Projects\capstone-bakery-inventory-manager\frontend\src\components\recipes\RecipeIngredientsListing.js", "JavaScript", 0, 26, 0, 2, 4, 32
"c:\Users\jondm\OneDrive\Desktop\Projects\capstone-bakery-inventory-manager\frontend\src\components\recipes\RecipeView.js", "JavaScript", 0, 105, 0, 6, 8, 119
"c:\Users\jondm\OneDrive\Desktop\Projects\capstone-bakery-inventory-manager\frontend\src\components\recipes\RecipesCreate.js", "JavaScript", 0, 7, 0, 0, 0, 7
"c:\Users\jondm\OneDrive\Desktop\Projects\capstone-bakery-inventory-manager\frontend\src\components\recipes\RecipesList.js", "JavaScript", 0, 21, 0, 5, 7, 33
"c:\Users\jondm\OneDrive\Desktop\Projects\capstone-bakery-inventory-manager\frontend\src\components\recipes\RecipesListing.js", "JavaScript", 0, 9, 0, 0, 2, 11
"c:\Users\jondm\OneDrive\Desktop\Projects\capstone-bakery-inventory-manager\frontend\src\components\recipes\RecipesView.js", "JavaScript", 0, 19, 0, 1, 3, 23
"c:\Users\jondm\OneDrive\Desktop\Projects\capstone-bakery-inventory-manager\frontend\src\context\AlertsContext.js", "JavaScript", 0, 23, 0, 1, 6, 30
"c:\Users\jondm\OneDrive\Desktop\Projects\capstone-bakery-inventory-manager\frontend\src\context\AuthContext.js", "JavaScript", 0, 61, 0, 11, 12, 84
"c:\Users\jondm\OneDrive\Desktop\Projects\capstone-bakery-inventory-manager\frontend\src\context\IngredientsContext.js", "JavaScript", 0, 55, 0, 0, 14, 69
"c:\Users\jondm\OneDrive\Desktop\Projects\capstone-bakery-inventory-manager\frontend\src\context\RecipesContext.js", "JavaScript", 0, 177, 0, 2, 29, 208
"c:\Users\jondm\OneDrive\Desktop\Projects\capstone-bakery-inventory-manager\frontend\src\context\UnitsContext.js", "JavaScript", 0, 57, 0, 1, 15, 73
"c:\Users\jondm\OneDrive\Desktop\Projects\capstone-bakery-inventory-manager\frontend\src\index.js", "JavaScript", 0, 27, 0, 0, 3, 30
"c:\Users\jondm\OneDrive\Desktop\Projects\capstone-bakery-inventory-manager\frontend\src\utils\convertUnits.js", "JavaScript", 0, 11, 0, 0, 4, 15
"c:\Users\jondm\OneDrive\Desktop\Projects\capstone-bakery-inventory-manager\frontend\src\utils\getIngredientShortages.js", "JavaScript", 0, 23, 0, 0, 7, 30
"c:\Users\jondm\OneDrive\Desktop\Projects\capstone-bakery-inventory-manager\frontend\src\utils\handleInputChange.js", "JavaScript", 0, 7, 0, 0, 1, 8
"c:\Users\jondm\OneDrive\Desktop\Projects\capstone-bakery-inventory-manager\frontend\src\utils\loginWithToken.js", "JavaScript", 0, 26, 0, 7, 6, 39
"c:\Users\jondm\OneDrive\Desktop\Projects\capstone-bakery-inventory-manager\frontend\src\utils\modalCloser.js", "JavaScript", 0, 5, 0, 3, 2, 10
"Total", "-", 18472, 1586, 26, 65, 210, 20359